重症监护室	A重症监护室
A重症监护室	A重症监护室
B重症监护室	B重症监护室
水杯	一次性水杯
中会议室	中会议室
中医乳腺外科	中医科
中医五官科	中医科
中医儿科	中医科
中医免疫内科	中医科
中医内分泌	中医科
中医呼吸科	中医科
中医外科	中医科
中医妇产科	中医科
中医心内科	中医科
中医感染内科	中医科
中医按摩科	中医科
中医消化科	中医科
中医男科	中医科
中医皮肤科	中医科
中医眼科	中医科
中医神经内科	中医科
中医科	中医科
中医老年病科	中医科
中医肛肠科	中医科
中医肝病科	中医科
中医肾病内科	中医科
中医肿瘤科	中医科
中医血液科	中医科
中医骨科	中医科
中央消毒供应	中央消毒供应
中药调剂	中药调剂
中西医结合科	中西医结合科
交费	交费窗口
交钱	交费窗口
产科+新生儿急救	产科+新生儿急救
人事办公室	人事办公室
人工授精手术室	人工授精手术室
传染危重室	传染危重室
传染科	传染科
体检中心	体检中心
体检科	体检科
儿科	儿科
免疫科	免疫科
全科	全科
内分泌科	内分泌科
内窥镜	内窥镜
办卡	办卡窗口
办就诊卡	办卡窗口
建档	办卡窗口
住院	办理住院处
出院	办理出院处
功能检查科	功能检查科
医学影像科	医学影像科
卫生间	卫生间
厕所	卫生间
洗手	卫生间
留便	卫生间
留尿	卫生间
发热/呼吸道门诊	发热/呼吸道门诊
取卵室	取卵室
取精室	取精室
取药	取药窗口
开药	取药窗口
拿药	取药窗口
儿童口腔科	口腔科
口腔修复科	口腔科
口腔急诊科	口腔科
口腔特诊科	口腔科
口腔科	口腔科
口腔粘膜科	口腔科
口腔预防科	口腔科
牙体牙髓科	口腔科
牙周科	口腔科
看牙	口腔科
司法鉴定科	司法鉴定科
呼吸科	呼吸科
哺乳室	哺乳室
轮椅	器械室
图书馆/电子阅览室	图书馆/电子阅览室
大会议室	大会议室
女科	女科
产前体检	妇产科
产前检查	妇产科
产前诊断科	妇产科
产检	妇产科
产科	妇产科
妇产科	妇产科
妇泌尿科	妇产科
妇科	妇产科
妇科内分泌	妇产科
孕期体检	妇产科
孕期检查	妇产科
孕检	妇产科
怀孕体检	妇产科
怀孕检查	妇产科
小会议室	小会议室
康复科	康复科
开水	开水间
打开水	开水间
打水	开水间
接开水	开水间
接水	开水间
热水	开水间
微创外科	微创外科
心理咨询科	心理咨询科
心脏康复中心	心脏康复中心
心血管内科	心血管内科
心血管卓越中心	心血管卓越中心
心血管外科	心血管外科
心血管康复	心血管康复
急诊科	急诊科
性病科	性病科
感染内科	感染内科
手术室	手术室
打印机	打印机
报告厅	报告厅
抽血	抽血室
采血	抽血室
挂号	挂号窗口
看病	挂号窗口
放射科	放射科
整形科	整形科
新生儿洗婴	新生儿洗婴
新生儿病房	新生儿病房
外科	普外科
普外科	普外科
普通外科	普外科
内科	普通内科
普通内科	普通内科
档案室	档案室
检验科	检验科
泌尿外科	泌尿外科
打针	注射室
注射	注射室
洗婴	洗婴
消化内科	消化内科
烧伤科	烧伤科
理疗科	理疗科
男科	男科
男科检查室	男科检查室
疫苗接种	疫苗接种
疼痛科	疼痛科
病房	病房
复印病历	病案室
病假证明	病案室
诊断书	病案室
诊断证明	病案室
领病历	病案室
病理科	病理科
皮肤科	皮肤科
皮肤美容科	皮肤科
眼科	眼科
磁共振	磁共振
礼品店	礼品店
功能神经外科	神经外科
神经内科	神经科
神经外科	神经科
神经科	神经科
种植科	种植科
精神科	精神科
结核病科	结核病科
老年病科	老年病科
耳鼻喉科	耳鼻喉科
职业病科	职业病科
肛肠科	肛肠科
肝病科	肝病科
肝胆外科	肝胆外科
肝胆科	肝胆外科
肾病内科	肾病内科
肾病科	肾病内科
肿瘤内科	肿瘤科
肿瘤外科	肿瘤科
肿瘤妇科	肿瘤科
肿瘤康复科	肿瘤科
肿瘤科	肿瘤科
肿瘤综合科	肿瘤科
胎心监护	胎心监护
胸外科	胸外科
脊柱外科	脊柱外科
脊柱科	脊柱外科
化验单	自助报告打印机
化验报告	自助报告打印机
化验结果	自助报告打印机
检查报告	自助报告打印机
检查结果	自助报告打印机
验血报告	自助报告打印机
验血结果	自助报告打印机
艾滋病科	艾滋病科
药剂科	药剂科
药物依赖科	药物依赖科
营养科	营养科
董事长办公室	董事长办公室
血液科	血液科
血液透析中心	血液透析中心
血管外科	血管外科
血管科	血管外科
血透中心	血透中心
行政/会议中心接待	行政/会议中心接待
访客餐厅	访客餐厅
财会办公室	财会办公室
贵宾接待	贵宾接待
b超	超声科
彩超	超声科
超声	超声科
超声科	超声科
足踝外科	足踝外科
输血科	输血科
过敏反应科	过敏反应科
运动医学科	运动医学科
遗传咨询科	遗传咨询科
重症监护室	重症监护室
针灸科	针灸科
阴道镜	阴道镜
预防保健科	预防保健科
颌面外科	颌面外科
骨关节科	骨关节科
创伤骨科	骨科
矫形骨科	骨科
骨科	骨科
骨肿瘤科	骨科
骨质疏松科	骨科
高压氧科	高压氧科
麻醉恢复	麻醉恢复
麻醉科	麻醉科
产房	一站式产房
体检	体检中心
儿科	儿科
哺乳	哺乳室
喂奶	哺乳室
看书	图书馆
复印	打印机
打印	打印机
婴儿病房	新生儿病房
注射疫苗	疫苗接种
买点礼品	礼品店
吃点东西	访客餐厅
吃饭	访客餐厅
用餐	访客餐厅
食堂	访客餐厅
图书馆	图书馆
手术室	手术室
听报告	报告厅
听讲座	报告厅
报告厅	报告厅
新生儿病房	新生儿病房
印病历	档案室
查档案	档案室
打疫苗	疫苗接种
买礼品	礼品店
买吃的	访客餐厅
吃东西	访客餐厅
饿	访客餐厅
零食	自动售货机
饮料	自动售货机
买水	自动售货机
喝水	自动售货机
